WWWWWWWWWWWWWWWWWWWWWW
WEEEEEEEEEEEEEEEEEEEEW
WEEEEEEEEEEEEEEEEEEEEW
WEEEEEEEEEEEEEEEEEEEEW
WEEEEEEEEEEEEEEEEEEEEW
WEEEEEEEEEEEEEEEEEEEEW
WEEEEEEEEEEEEEEEEEEEEW
WEEEEE#EEEEEEEEEEEEEEW
WEEEEEEEEEEEEEEEEEEEEW
WEEEEEEEEEEEEEEEEEEEEW
WEEEEEEEEEEEEEEEEEEEEW
WEEEEEEEEEEEEEEEEEEEEW
WWWWWWWWWWWWWWWWWWWWWW
